NO ./textures/walls/stone00.xpm
SO ./textures/walls/stone01.xpm
WE ./textures/walls/stone02.xpm
EA ./textures/walls/stone03.xpm

F 169,169,169
C 52,52,52

 111111111111111       111
10000000000S00001     10001
 10000000000000001111100001
 1000000001D100000000000001
 1000000001T10000000000001
  10000001111111100000001
   1000001       10000001
   1000001       10000001
   100001111111110000001
   100000000000000000001
    1000000000000000111
     1111111111111D11111111111111
     10000000000000000000000000001
     10000000000000000000000000001
     10000000000000000000000000001
     10000000000000000000000000001
     10000000000111111111110000001
     100000000001          1000001
     1000000000011111111111100001
     100000000001000000000000001
     10000000000100000000000001
      111111111111111111111111
