NO ./assets/texture/gogh/starry_night.xpm
SO ./assets/texture/gogh/rhone.xpm
WE ./assets/texture/gogh/portrait.xpm
EA ./assets/texture/gogh/cafeterrace.xpm

F 3,3,30
C 0,0,55

1111111111111111111111111
10E0000000000111000000001
1000000000000000000000001
1000010000000000000000001
1000000000111111111000001
1000000000100000000000001
1000000000100000000000001
1000000000111111111100001
1000000000100000000100001
1000000000100010000100001
1000000000100000000100001
100000000011111D111100001
1000000000000000000000001
1000000000000000000000001
1000000000000000000000001
111111111111111111D111111
1000000000000000000000001
1000011111111100000000001
10000D0000000100001000001
1000010000000111111000001
100001000000T100000000001
1111111111111111111111111
