NO ./assets/texture/walls/brick.xpm
SO ./assets/texture/walls/stone.xpm
WE ./assets/texture/walls/brown.xpm
EA ./assets/texture/walls/wood.xpm

F 112,112,112
C 56,56,56

11111111111111111111111111
11000000000110000000000001
11011000001110000000000001
10010000000000000000000011111
11111111101100000111000000001
10000000001100000111011111111
11110111111111011100000010001
11110111111111011101010010001
11000000110101011100000010001
10000000000000001100000010001
10000000000000001101010010001
11000001110101011111011110N01
11110111111010110111101000111
11111111111111111111111111111
