NO ./assets/texture/walls/stone00.xpm
SO ./assets/texture/walls/stone01.xpm
WE ./assets/texture/walls/stone02.xpm
EA ./assets/texture/walls/stone03.xpm

F 169,169,169
C 52,52,52

11111111111111111111111111111111111111111111111111111111111111111111111
10100000000000000000000000000000000000000000000000000000000000000000001
10001111111011111111110111111110111111111110111111111111101111111110111
10100000000001010001000111111110001000100010100000000000000000000000001
10111011111111000100010000000000100010001000100000000000000000000000001
10001010001000111110111110111111111111111110101111111111111111111111101
10101000100010000000000000000000000000000000000000000000000000000000001
10101111111111111110111111111111111111111111111101111111111111111111101
10100000001000100010001000100010001000100010001000100010001000100010001
10010000001010101010101010101010101010101010101010101010101010101010101
10111111101010101010101010101010101010101010101010101010101010101010101
10100010101010101010101010101010101010101010101010101010101010101010101
10001010101010101010101010101010101010101010101010101010101010101000101
1N110000000010001000100010001000100010001000100010001000100010001001001
11111111111111111111111111111111111111111111111111111111111111111111111
