                  1111  
                 100001 
 1111111111111111001101 
10000000000000000000N1  
 11101111111111111111   
                        
                        
11                      
101                     
1001                    
                        
              1001      
              1001      
               11       
                        