NO ./textures/walls/stone00.xpm
SO ./textures/walls/stone01.xpm
WE ./textures/walls/stone02.xpm
EA ./textures/walls/stone03.xpm

F 169,169,169
C 52,52,52

111111111111111111111111
100000000000000000000001
100000000000000000000001
100000000000000000000001
100000000000000000000001
100000000000000000000001
100000000000000000000001
100000111110000101010001
100000100010000D00000001
100000100010000100010001
100000100010000000000001
100000111100001010100001
100000000000000000000001
100000000000S00000000001
100000000000000000000001
100000000000T00000000001
111111111111D11111111111
100000000000000000000001
100000000000000000000001
111111111000000000000001
100100001000000000000001
100000101000000000000001
100100001000000000000001
100111111000000000000001
100000000000000000000001
111111111111111111111111
