NO ./textures/test/north.xpm
SO ./textures/test/south.xpm
WE ./textures/test/west.xpm
EA ./textures/test/east.xpm

F 169,169,169
C 52,52,52

 1111111111111111111111
100000000000000000000001
100000000000000000000001
100000000000000000000001
100000000000000000000001
100000000000000000000001
10000000000000000000001
100000111110000101010001
100000100010000D00000001
10000010010000100010001
100000100010000000000001
10000011100001010100001
10000000000000000000001
1000000000000T000000001
 100000000000000000001
  1000000000000000001
   111111111D1111111
   100000000000000001
  100000E0000000000001
 1111111100000000000001
100100001000000000000001
100000101000000000000001
100100001000000000000001
1001111110000T0000000001
100000000000000000000001
 1111111111111111111111
